111111111111111
100000000000001
100000000000001
100000000000001
100000001000001
10000CE1P000001
100000001000001
100000000000001
100000000000001
100000000000001
111111111111111