111111111111111111111
100000000000000000001
100000000000000000001
100000000000000000001
100000000000000000001
100000P1C1E0000000001
100000000000000000001
100000000000110000001
100000100000000000001
100000000000000000001
100000010000000000001
100000000010000000001
100000000000000000001
111111111111111111111
