1111111111111111111111111111111111111111111111111
1010101010101010101010101010101010101010101010101
10000000000000000000000000000000000000000000000C1
1010101010101010101010101010101010101010101010101
1000000000000000000000000000000000000000000000001
1010101010101010101C10101C10101010101010101010101
100000000000000000000P000000000000000000000000001
1010101010101010101010101010101010101010101010101
100000000000000E000010100000000000000000000000001
101010101010101C10101C101010101010101010101010101
10000000000000000000000000C0000000000000000000001
1010101010101010101010101010101010101010101010101
1000000000000000000000000000000000000000000000001
1010101010101010101010101010101010101010101010101
1000000000000000000000000000000000000000000000001
1010101010101010101010101010101010101010101010101
1000000000000000000000000000000000000000000000001
10101010101010101010101010101010101010101010101C1
1111111111111111111111111111111111111111111111111
