111111111111111
1E0000000000001
10000000P000001
100000000000001
100000011100001
10000001C010001
100000011100001
100000000000001
100000000000001
1000000000000C1
111111111111111