1111111111111111
1000000000010001
1000000000010001
1000000000010001
1000000000010001
1000000000010000
10000P1C1E010001
1000000000010001
1000000000010001
1000000000010001
1000000000010001
1000000000010001
1111111111111111