111111111111111
100000000000001
100000000000001
100000000000001
100000000000001
10000C000E00001
100000000000001
100000000000001
100000000000001
100000000000001
111111111111111