111111111111111
100000000000001
100000000000001
100000000000001
100000011110001
10000P0C1E01001
100000011110001
100000000000001
100000000000001
100000000000001
111111111111111