11111111111
10000000001
10000000001
10P1C1E0001
10000000001
11111111111