1111111111111111111111111111111111111111111111111111
1P0000000000000000000000000000000C00000C000000000001
1000000000000000000000000000000000000000000000000001
1010010100100000000000000000000000101001000000010101
0010010000000000000000000010101010001001000000010101
1000000000000000000000000000000000000000000000000001
10000000000000000000001E1000000000000000000000000001
1000000000000000000000111000000000000010000000000001
100000000C00C0000000000000000000000000000000000000C1
100000000C00C0000000000000000000000000000000000000C1
1111111111111111111111111111111111111111111111111111